P	P
B	B
T	T
D	D
K	K
G	G
CH	CH
JH	JH
F	F
V	V
TH	TH
DH	DH
S	S
Z	Z
SH	SH
ZH	ZH
HH	HH
M	M
EM	EM
N	N
EN	EN
NG	NG
ENG	ENG
L	L
EL	EL
R	R
DX	DX
NX	NX
Y	Y
W	W
Q	Q
AA	AA
IY	IY
EH	EH
IH	IH
UH	UH
AH	AH
AX	AX
AE	AE
EY	EY
AY	AY
OY	OY
ER	ER
