P	P
B	B
T	T
D	D
K	K
G	G
CH	CH
JH	JH
F	F
V	V
TH	TH
DH	DH
S	S
Z	Z
SH	SH
ZH	ZH
HH	HH
M	M
EM	EM
N	N
EN	EN
NG	NG
ENG	ENG
L	L
EL	EL
R	R
DX	DX
NX	NX
Y	Y
W	W
Q	Q
AO	AO
AA	AA
IY	IY
UW	UW
EH	EH
IH	IH
UH	UH
AH	AH
AX	AX
AE	AE
EY	EY
AY	AY
OW	OW
AW	AW
OY	OY
ER	ER
L-AO	L AO
L-AA	L AA
L-IY	L IY
L-UW	L UW
L-EH	L EH
L-IH	L IH
L-UH	L UH
L-AH	L AH
L-AX	L AX
L-AE	L AE
L-EY	L EY
L-AY	L AY
L-OW	L OW
L-AW	L AW
L-OY	L OY
L-ER	L ER
